000000000000000000000000000000000011111111111111000
000000000000000000000000000000000122222222222221000
000000000000000000000000000000001222222222222221000
000000000000000000000000000001112222222222222211000
000000000000000000000000011112222222222222222210000
000000000000000000000011102222222222222222222210000
000000000000000000011122222222222222222222222210000
000000000000111111122222222222222222222222222100000
000000000001222222222222222222222222222222222100000
000000000001222222222222222222222222222222211100000
000000000001222222222222222222222222222222100000000
000000000000122222222222222222222222222222100000000
000000000000122222222222222222222222222221000000000
000000000111222222222222222222222222222221000000000
000000001222222222222222222222222222222210000000000
000000111222222222222222222222222211112210000000000
000001222222222222222222222222221100001100000000000
000012222222222222222222222222210000000000000000000
000012222222222222222222222222210000000000000000000
000122222222222222222222222221100000000000000000000
001222222222222222222222222221000000000000000000000
001222222222222222222222221110000000000000000000000
000122222222222222222222110000000000000000000000000
000122222222222222222221000000000000000000000000000
000122222222222222222210000000000000000000000000000
000122222222222222222210000000000000001111000000000
000122222222222222222210011111111111112222100000000
000122222222222222222221122222222222222222210000000
000011222222222222222222222222222222222222221000000
000000111111222222222222222222222222222222221100000
000000000000111122222222222222222222222222222211100
000000000000000012222222222222222222222222222222210
000000000000000012222222222222222222222222222222210
000000000000000012222222222221122222222222222222100
000000000000110012222222222222222222222222222221000
000000000000121122222222222222222222222222222221000
000000000001222222222222222222222222222222222221000
000000000001222222222222222222222222222222222221000
000000000012222222222222222222222222222222222222100
000000000012222222222222222222222222222222222222210
000000000122222222222222222222222222222222222221100
000000001122222222222222222112222222211111111110000
000000112222222222222222211011111111100000000000000
000000122222222222222222100000000000000000000000000
000000122222222222222221000000000000000000000000000
000000112222222222222210000000000000000000000000000
000000012222222222211110000000000000000000000000000
000000012222222222100000000000000000000000000000000
000001122222222221000000000000000000000000000000000
000001222222222221000000000000000000000000000000000
000012222222222210000000000000000000000000000000000
000122222222222210000000000000000000000000000000000
001222222222222210000000000000000000000000000000000
012222222222222210000000000000000000000000000000000
012222222222222210000000000000000000000000000000000
012222222222222221000000000000000000000000000000000
012222222222222221000000000000000000000000000000000
001222222222222210010000000000000000000000000000000
001222222222222221121000000000000000000000000000000
001222222222222222221000000000000000000000000000000
001222222222222222222100000000000000000000000000000
001222222222222222222211000000000000000000000000000
000122222222222222222222110000000000000000000000000
000012222222222222222222221000000000000000000000000
000012222222222222222222221000000000000000000000000
000001222222222222222222221000000000000000000000000
000001222222222222222222221000000000000000000000000
000000122222222222222222210000000000000000000000000
000000122222222222222222210000000000000000000000000
000000122222222222222221100000000000000000000000000
000001222222222222222110000000000000000000000000000
000001222222222222221000000000000000000000000000000
000112222222222222110000000000000000000000000000000
000122222222222211000000000000000000000000000000000
001122222222111100000000000000000000000000000000000
001222222221000000000000000000000000000000000000000
001222222221000000000000000000000000000000000000000
000122222221000000000000000000000000000000000000000
000012222222100000000000000000000000000000000000000
000012222222100000000000000000000000000000000000000
000012222222100000000000000000000000000000000000000
000012222211000000000000000000000000000000000000000
000112222211000000000000000000000000000000000000000
000111111111000000000000000000000000000000000000000
000122222210000000000000000000000000000000000000000
000122222210000000000000000000000000000000000000000
000122222210000000000000000000000000000000000000000
000122222210000000000000000000000000000000000000000
000122222210000000000000000000000000000000000000000
000001111100000000000000000000000000000000000000000